
EA	./Textures/wood.xpm

NO	./Textures/grass.xpm

SO	./Textures/stone.xpm

WE	./Textures/metal.xpm




R 1200 800

C 225,30,90

F 63,225,29

S	./Textures/brick.xpm

11111111111111111111
1000000002220000111
1111000000000000011
10000000000002220011
10000000000200000011
10000000000200000011
10000000000000000011
10000000000200000011
1N001002211111110011
1111111111111111111
