
EA	./Textures/wood.xpm

NO	./Textures/grass.xpm

SO	./Textures/stone.xpm

WE	./Textures/metal.xpm




R 2500 2000

C 225,30,90

F 63,225,29

S	./Textures/brick.xpm

        1111111111111111111111111
        1000000000110000000000001
        1011000001110000000000001
        1001000000000000000000001
111111111011000001110000000000001
100000000011000001110111111111111
11110111111111011100000010001
11110111111111011101010010001
1100000011010101 100000010001
10000000000000011100000010001
10000001110000001101010010001
11000001 10101011111011110N0111
11110111 1110111 101111010001
11111111 1111111 111111111111
