
EA	./Textures/wood.xpm

NO	./Textures/grass.xpm

SO	./Textures/stone.xpm

WE	./Textures/metal.xpm




R 2500 2000

C 225,30,90

F 63,225,29

S	./Textures/brick.xpm

11111111
10000001
11110001
10001001
10001001
1N001001
11111111
